slump  	s l V m p
crank  	k r { N k
gorge  	g O: dZ
query  	k w @ r I
drink  	d r I N k
favor  	f eI v @
abbey  	{ b I
tangy  	t { n dZ I
panic  	p { n I k
solar  	s @U l @
shire  	S @
proxy  	p r Q k s I
point  	p OI n t
robot  	r @U b @ t
prick  	p r I k
wince  	w I n s
crimp  	k r I m p
knoll  	n l
sugar  	s U g @
whack  	w { k
mount  	m aU n t
perky  	p k I
could  	k U d
wrung  	r V N
light  	l aI t
those  	D @U z
moist  	m O: s t
shard  	S A: d
pleat  	p l i: t
aloft  	@ l Q f t
skill  	s k I l
elder  	e l d @
frame  	f r eI m
humor  	h j u: m @
pause  	p O: z
ulcer  	V l s @
ultra  	V l t r @
robin  	r Q b I n
cynic  	s I n I k
aroma  	@ r @U m @
caulk  	k O: l k
shake  	S eI k
dodge  	d Q dZ
swill  	s w I l
tacit  	t { s I t
other  	V D @
thorn  	T O: n
trove  	t r @U v
bloke  	b l @U k
vivid  	v I v I d
spill  	s p I l
chant  	t S @ n t
choke  	t S @U k
rupee  	r V p i:
nasty  	n @ s t I
mourn  	m aU r n
ahead  	@ h e d
brine  	b r I n
cloth  	k l Q T
hoard  	h O: d
sweet  	s w i: t
month  	m V n T
lapse  	l { p s
watch  	w Q t S
today  	t @ d eI
focus  	f @U k @ s
smelt  	s m e l t
tease  	t i: s
cater  	k { t @
movie  	m u: v I
saute  	s O: t
allow  	@ l @U
renew  	r I n j u:
their  	D e@
slosh  	s l @U S
purge  	p 3: dZ
chest  	t S e s t
depot  	d e p @U
epoxy  	e p Q k s I
nymph  	n I m f
found  	f aU n d
shall  	S { l
stove  	s t @U v
lowly  	l @U l I
snout  	s n t
trope  	t r @U p
fewer  	f j u: @
shawl  	S O: l
natal  	n @ t l
comma  	k @ m @
foray  	f Q r eI
scare  	s k e@
stair  	s t e@ @
black  	b l { k
squad  	s k w Q d
royal  	r OI @ l
chunk  	t S V N k
mince  	m I n s
shame  	S eI m
cheek  	t S i: k
ample  	{ m p l
flair  	f l e@
foyer  	f OI @
cargo  	k A: g @U
oxide  	Q k s aI d
plant  	p l A: n t
olive  	Q l I v
inert  	I n t
askew  	A: s k j u:
heist  	h I I s t
shown  	S @U n
zesty  	z e s t I
trash  	t r @ S
larva  	l A: @ v @
forgo  	f g @U
story  	s t O: r I
hairy  	h e@ r I
train  	t r eI n
homer  	h @U m @
badge  	b { dZ
midst  	m I d s t
canny  	k { I
shine  	S aI n
gecko  	dZ e k @U
farce  	f A: s
slung  	s l V N
tipsy  	t I p s I
metal  	m e t l
yield  	j i: l d
delve  	d e l v
being  	b i: I N
scour  	s k u: @
glass  	g l A: s
gamer  	g eI m @
scrap  	s k r eI p
money  	m V n I
hinge  	h I n dZ
album  	O: l b V m
vouch  	v aU t S
asset  	@ s I t
tiara  	S { r @
crept  	k r e p t
bayou  	b eI j u:
atoll  	{ t @U l
manor  	m @ n @
creak  	k r eI k
showy  	S @U I
peach  	p i: t S
froth  	f r Q T
depth  	d e p T
gloom  	g l u: m
flood  	f l V d
trait  	t r eI t
girth  	g 3: T
piety  	p aI @ t I
goose  	g u: @U z
float  	f l @U t
donor  	d Q n @
atone  	@ t n
primo  	p r aI m @U
apron  	eI p r @ n
blown  	b l @U n
cacao  	k { k aU
loser  	l @U z @
input  	I n p U t
gloat  	g l @U t
awful  	O: f @ l
brink  	b r I N k
smite  	s m I t
beady  	b e d I
rusty  	r V s t I
retro  	r I t r @U
droll  	d r @U l
gawky  	g O: k I
hutch  	h V t S
pinto  	p I n t @
egret  	i: g r e t
lilac  	l aI l @ k
sever  	s I v @
field  	f i: l d
fluff  	f l V f
agape  	@ g @ p
voice  	v OI s
stead  	s t e d
berth  	b 3: T
madam  	m @ d @ m
night  	n aI t
bland  	b l { n d
liver  	l I v @
wedge  	w e dZ
roomy  	r u: m I
wacky  	w { k I
flock  	f l Q k
angry  	{ N g r I
trite  	t r I t
aphid  	eI p I
tryst  	t r aI s t
midge  	m I d dZ
power  	p aU @
elope  	I l @U p
cinch  	s I n t S
motto  	m @U t @U
stomp  	s t @ m p
upset  	V p s e t
bluff  	b l u: f
cramp  	k r { m p
quart  	k w t
coyly  	k OI l I
youth  	j u: T
rhyme  	r I m
buggy  	b V g I
alien  	eI l I@ n
smear  	s m I@
unfit  	V n f I t
patty  	p { I
cling  	k l I N
glean  	g l i: n
label  	l eI b l
hunky  	h V N k I
khaki  	k eI k I
poker  	p @U k @
gruel  	g r u: @ l
twice  	t w aI s
twang  	t w Q N
shrug  	S r V g
treat  	t r i: t
waste  	w Q s t
merit  	m e r I t
woven  	w @U v n
needy  	n i: d I
clown  	k l @U n
irony  	aI @ Q n I
ruder  	r u: d @
gauze  	g O: z
chief  	t S i: f
onset  	w n s I t
prize  	p r aI z
fungi  	f V V n dZ I
charm  	t S A: m
gully  	g V l I
inter  	I n t @
whoop  	w Q p
taunt  	t O: n t
leery  	l I r I
class  	k l A: s
theme  	T i: m
lofty  	l Q f t I
tibia  	t I b I@
booze  	b u: z
alpha  	{ l f @
thyme  	D aI m
doubt  	d aU t
parer  	p e@ r @
chute  	t S j t
stick  	s t I k
trice  	t r aI s
alike  	@ l aI k
recap  	r k { p
saint  	s eI n t
glory  	g l O: r I
grate  	g r eI t
admit  	@ d m I t
brisk  	b r I s k
soggy  	s Q g I
usurp  	j u: U@ @ p
scald  	s k O: l d
scorn  	s k O: n
leave  	l i: v
twine  	t w aI n
sting  	s t I N
bough  	b O:
marxh  	m A: r k z
sloth  	s l Q T
dandy  	d A: n d I
vigor  	v I g @
howdy  	h aU d I
enjoy  	I n dZ OI
valid  	v @ l I d
ionic  	aI Q n I k
equal  	I k w @ l
floor  	f l O:
catch  	k { t S
spade  	s p eI d
stein  	s t aI n
exist  	I g z I s t
quirk  	k w 3: k
denim  	d e n I m
grove  	g r @U v
spiel  	s p l
mummy  	m V m I
fault  	f O: l t
foggy  	f Q g I
flout  	f l aU t
carry  	k { r I
sneak  	s n i: k
libel  	l I b l
waltz  	w Q l t
aptly  	@ p t l I
piney  	p I n i:
inept  	I n p t
aloud  	@ l aU d
photo  	f @U t @U
dream  	d r i: m
stale  	s t { l
begin  	b I g I n
spell  	s p e l
rainy  	r eI n I
unite  	j u: n aI t
medal  	m e d l
valet  	v eI l e t
inane  	I n { n
maple  	m { p l
snarl  	s n A: l
baker  	b eI k @
there  	D e@
glyph  	g l I f
avert  	{ v 3: t
brave  	b r eI v
axiom  	{ k s S m
prime  	p r aI m
drive  	d r aI v
feast  	f i: s t
itchy  	I t I
clean  	k l i: n
happy  	h { p I
tepid  	t e p I d
undue  	V n d j u:
study  	s t V V d I
eject  	I dZ e k t
chafe  	S A: f
torso  	t O: s @U
adore  	@ d O:
woken  	w @U k @ n
amber  	{ m b @
joust  	dZ s t
infer  	I n f 3:
braid  	b r eI d
knock  	n Q k
naive  	n eI v
apply  	@ p l aI
spoke  	s p @U k
usual  	j u: Z U@ l
rival  	r I v l
probe  	p r @U b
chord  	k d
taper  	t eI p @
slate  	s l eI t
third  	T 3: d
lunar  	l u: n A:
excel  	I k s @ l
aorta  	O: t @
poise  	p OI z
extra  	I k s t r @
judge  	dZ V dZ
condo  	k @ n d @U
impel  	I m p e l
havoc  	h eI v Q k
molar  	m Q l @
manly  	m { n l I